33afak	3afak
3aafak	3afak
3aand	3and
3aand	3aned
3abarti	3ber
3abdessalam	abdessalam
3acha	3ach
3adiro	dar
3afaak	3afak
3afana	3afa
3ahir	3ahira
3ajbatni	3jabni
3ajbo	3jbo
3alaam	3alam
3alaqaa	3alaqa
3alih	3lih
3alik	3lik
3allam	3alam
3amri	3amarni
3amrni	3amarni
3andek	3andak
3andha	3andak
3andk	3andak
3aned	3nad
3aq	3ayaq
3aqna	3aq
3aqo	3aq
3ardek	3aradek
3arefe	3aref
3assir	3asir
3awdat	3awd
3awnoni	3awnouni
3awtanii	3awtani
3aya	3ayan
3ayb	3ib
3ayq	3ayaq
3aziz	3ziz
3barti	3ber
3brti	3ber
3chiri	3chir
3d	3and
3ebrat	3bar
3ech	3ach
3ela	3la
3emri	3amarni
3end	3and
3end	3nad
3erfek	3ref
3etikom	ya3tek
3fak	3afak
3fo	3fou
3ibadlh	3ibadlah
3ide	3id
3in	3ain
3iqna	3aq
3jabto	3jbo
3jbatni	3jabni
3jbni	3jabni
3jbtini	3jabtini
3jebni	3jabni
3jebtini	3jabtini
3laa	3la
3lak	3lik
3lam	3alam
3lama	3alam
3lash	3lach
3lek	3lik
3lia	3liya
3lih	3la
3liha	3la
3liha	3lih
3lihe	3lih
3lihom	3lih
3liih	3lih
3liik	3lik
3lika	3lik
3like	3lik
3likh	3lik
3liki	3lik
3likk	3lik
3likom	3lik
3likomm	3lik
3likoom	3lik
3likoum	3lik
3likum	3lik
3liy	3liya
3liyaa	3liya
3liyak	3liya
3liyya	3liya
3lk	3lik
3llik	3lik
3ly	3liya
3lya	3liya
3marhom	3amro
3mri	3amarni
3mrni	3amarni
3nad	3and
3nd	3and
3nd	3aned
3nd	3nad
3ndd	3aned
3ned	3aned
3omrk	3amrak
3omro	3amro
3ors	3ars
3oumar	3omar
3qna	3aq
3rafto	ma3raftch
3rasiya	3ers
3rd	3red
3ti	3ati
3tikom	ya3tek
3wnoni	3awnouni
3yach	3ach
3yalt	3yalat
3ycha	3icha
3zaz	3ziz
3zez	3ziz
3ziiz	3ziz
3ziiza	3ziz
3ziza	3ziz
3zize	3ziz
3zizz	3ziz
7aaqd	7aqd
7ach	7acha
7ad	7ed
7adaak	7adek
7adak	7adek
7addek	7adek
7addk	7adek
7addo	7adek
7adeek	7adek
7adeer	7adar
7adekk	7adek
7adk	7adek
7adkum	7adek
7ado	7adek
7aja	7aj
7amad	7amd
7amad	7amed
7aqad	7aqd
7asit	7assa
7awela	7awla
7choma	7chouma
7chuma	7chouma
7d	7ed
7ddek	7adek
7dek	7adek
7dk	7adek
7ed	7ad
7ed	wa7ed
7eddek	7adek
7edeek	7adek
7edek	7adek
7edk	7adek
7elqa	7alqa
7eriq	7raq
7libe	7lib
7lqa	7alqa
7maditi	7amd
7oq	7oqoq
7sn	7sen
7ssan	7sen
7ssen	7sen
7ssn	7sen
a3ami	3ami
a3daa	a3dae
a3ibad	3ibad
a3lik	3lik
a3omar	3omar
a7sane	a7san
a7sen	a7san
a7sn	a7san
a7ssan	a7san
a7ssane	a7san
a7ssen	a7san
aabonaw	abonna
aakhiiran	akhiran
aakhiran	akhiran
aala	ala
abbonaw	abonna
abderhim	abderrahim
abdesalam	abdessalam
abdslam	abdessalam
abona	abonna
abonaw	abonna
abonay	abonna
abonit	abonna
abonite	abonna
abonn	abonna
abonnaw	abonna
abonnawe	abonna
abonnay	abonna
abounaw	abonna
achaf	chaf
achemn	achmen
achf	chaf
achman	achmen
achmata	chmata
achmn	achmen
achno	chno
adhan	adan
adrari	drari
ahesan	a7san
ahsan	a7san
ahsane	a7san
ahsen	a7san
ahsn	a7san
ahsne	a7san
ahssan	a7san
ahssen	a7san
ahssn	a7san
ajma3in	jami3an
ajma3in	jmi3
akbarr	akbar
akber	akbar
akbr	akbar
akbra	akbar
akh	akhor
akhar	akhor
akhay	khouya
akheti	khti
akhiiran	akhiran
akhiraa	akhiran
akhiraan	akhiran
akhirane	akhiran
akhor	okhra
akhouy	khouya
akhouya	khouya
akhoya	khouya
akhra	akher
akhra	khera
akhra	okhra
akhti	khti
akhuya	khouya
akiran	akhiran
aklakh	kalakh
alaah	allah
alach	3lach
alah	allah
alahe	allah
aleykom	3alaykoum
aleykoum	3alaykoum
aleykum	3alaykoum
alh	allah
alhmr	7mar
alhbiba	7biba
allaha	allah
allahe	allah
allahi	allah
allaho	allah
allahu	allah
allahy	allah
allh	allah
alli	ali
alwalidin	walidin
amin	amine
amine	amen
amma	ama
anakart	nkar
anchallah	inchallah
anchof	nchof
andak	3andak
andk	3andak
ant	nta
anti	nti
aqrab	qrab
arad	ard
arajae	rajae
ared	ard
arkhes	rkhes
arwijl	rajla
asa3aya	s3aya
asa7bi	sa7bi
asaha	sa7a
asahbi	sa7bi
asat	sat
asate	sat
asir	sir
asln	aslan
asmaa	asmae
assa7a	sa7a
assaf	asaf
assaha	sa7a
assahbi	sa7bi
assat	sat
asslan	aslan
atbarkallah	tbarekallah
atoubi	toubi
awal	awel
awald	weld
awale	awel
aweld	weld
awil	wil
awili	wili
awl	awel
awla	wla
awld	weld
awle	awel
awqef	wqef
awwal	awel
azwmil	zmel
b3da	ba3da
ba3d	b3id
baa	ba
baada	ba3da
babak	baba
bache	bach
bachi	bach
baghi	bgha
baghin	baghi
bagri	begri
baid	bayd
bakatni	bkite
bakit	bkite
bakitini	bkite
bakitona	bkite
balkhir	bikhir
bania	bniya
bant	bent
barak	baraka
barak	barek
baramij	barnamaj
barik	barek
bark	baraka
barki	barek
barmil	bermil
bas7	basa7
basel	bassel
bayn	bayan
bayna	bayan
bazzaf	bezzaf
bba	ba
bde7k	da7k
bdhar	dahr
bdik	dik
be3da	ba3da
bech	bach
beek	bik
begra	bagra
belkher	bikhir
belkhir	bikhir
beqa	bqa
beqat	bqa
beqaw	bqa
berrani	berani
bess	bass
bezaaf	bezzaf
bezaf	bezzaf
bezafe	bezzaf
bezaff	bezzaf
bezaz	bzez
bgha	baghi
bghat	bagha
bghaw	baghi
bghaw	bgha
bhal	b7al
bhl	b7al
bhsab	7sab
bi3t	bi3
bibii	bibi
biik	bik
bikhirr	bikhir
bikm	bikom
bikom	bik
bikoum	bik
bikoum	bikom
bine	bin
binek	bin
binha	bin
bini	bin
bink	bin
bino	bin
bjalil	jalil
bjouj	jouj
bkate	bka
bkatni	bkite
bkiit	bkite
bkit	bkite
bla3yalat	3yalat
blaan	blan
bladna	blad
blassa	blasa
blghrbal	gherbal
blkhair	bikhir
blkher	bikhir
blkhiir	bikhir
blkhir	bikhir
blkhirr	bikhir
bnadm	bnadem
bniin	bnin
bnina	bnin
bninn	bnin
bnouta	bnita
bnt	bent
boghaz	boughaz
boughaaz	boughaz
bqaat	bqa
bqat	bqa
bqate	bqa
bqaw	bqa
bqiti	bqa
braka	baraka
bssah	basa7
bstila	bastila
bstilla	bastila
btawfiq	tawfiq
bya3	ba3
bzzaaf	bezzaf
bzzf	bezzaf
chaallah	inchallah
chabe	chab
chafar	chefar
chafr	chefar
chafto	chaft
challah	inchallah
chamali	chamal
chamia	chami
chamkr	chamkar
chamt	chamata
chanaqa	chnaqa
charafe	charaf
chawto	chawahto
cheb	chab
cheba	chebba
cheffar	chefar
cheft	chaft
chefto	chaft
chehar	chhar
chamt	chamata
chenaq	chnouqat
chenaqa	chnaqa
chet7a	chat7a
chetha	chat7a
chfar	chefar
chft	chaft
chgal	chghal
chgol	chghol
chhr	chhar
chhrayn	chhar
chiban	chayb
chika	chikha
chinaqa	chnouqat
chitaan	chetan
chitawil	tawil
chkon	chkoun
chkone	chkoun
chkoune	chkoun
chkran	choukran
chlabi	chlahbi
chlahbia	chlahbi
chmalkom	chmal
chmat	chmata
chmkar	chamkar
chnaq	chnouqat
chnaqa	chnouqat
chnnaqat	chennaqa
chnoqat	chnouqat
chnou	chno
chnouqat	chnaqa
chnu	chno
chof	chouf
chofara	chefar
choha	chouha
chokarn	choukran
chokran	choukran
chokrane	choukran
choukrn	choukran
chqaf	chqef
chrab	cherab
chraf	charaf
cht7a	chat7a
chwia	chwiya
chwya	chwiya
d3moni	da3moni
d3mouni	da3moni
d7akti	d7ek
d7k	da7k
da3mona	da3moni
da3mouni	da3moni
daahk	da7k
dahak	da7k
dahek	da7k
dahir	daher
dahk	da7k
dahkna	d7ak
daiman	dayman
dair	dayer
dajalil	jalil
dajlil	jalil
dak	dik
dakhlat	dakhal
dakhol	dkhol
dare	dar
dariri	darora
daro	dar
darori	darouri
darou	dar
dayar	dayer
dayr	dayer
dazt	dazat
dazte	dazat
db	daba
ddahk	da7k
ddhk	da7k
de7k	da7k
dealo	dial
dehk	da7k
dek	dak
dek	dik
del	dal
dell	dal
dem	dam
denob	donoub
denobe	denb
derayf	draif
deryefa	draif
dewezto	dawazt
dewla	doula
deyal	dial
dghal	dghol
dhar	dher
dhk	da7k
dhktiini	da7k
dhro	dher
dialk	dial
dialo	dial
diik	dik
diima	dima
diir	dir
dik	dak
dimaa	dima
diman	dima
dimma	dima
dine	din
dino	din
dire	dir
diri	dir
dirna	dir
diro	dir
dirou	dir
diyal	dial
djaalil	jalil
djaj	djaja
djaliil	jalil
djalil	jalil
djalile	jalil
djalili	jalil
djalill	jalil
djalilo	jalil
djazayer	jazair
djlil	jalil
dk	dak
dk	dik
dkchi	dakchi
dkhalni	dakhal
dmou3i	dmou3
dnia	denya
dnob	dnoub
dok	dak
dok	dik
dola	doula
donia	dounya
donob	donoub
donya	dounya
dorosse	dorous
dorus	dorous
douazto	daz
dounia	dounya
dowzt	dawazt
draft	drafat
drayfa	drafat
dri	dari
driwcha	driwicha
droj	drouj
drti	dir
dunia	dounya
dwaztou	dawazt
dwezt	dawazt
dwzt	dawaz
dwzt	dawazt
dwztoo	dawazt
dyaaf	diaf
dyaf	diaf
dyal	dial
dyalou	dial
dyel	dial
dyl	dial
dzb	zeb
e3tik	ya3tek
en3al	n3al
en3alle	n3al
ensana	insana
esaha	sa7a
essa7a	sa7a
fa3lo	f3ayel
fachil	fachel
fade	fad
fahame	fahma
fakhr	fakher
fana	fenna
fanane	fanan
fane	fan
fanna	fana
fanna	fenna
faqrab	aqrab
faran	feran
farass	faras
farigh	faregh
fars	faras
fase	fas
fasia	fasi
fasida	fasda
fassed	fased
fayda	fayd
fayn	fin
fayza	faiza
fchaf	chaf
fed	fad
fek	fik
fel	fal
felmeghrib	meghrib
fena	fana
fena	fenna
fenna	fana
ffoula	folla
fhal	f7al
fhamet	fehm
fikk	fik
fikom	fik
finahoua	fino
fine	fin
fkar	fkarak
fkarek	fkarak
fkark	fkarak
fkhater	khater
fkrk	fkarak
fl7ayat	7ayat
flhadra	hadra
flkhawi	khawi
flkhiriya	khayriya
flmdina	mdina
floss	flouss
flous	flouss
flqanat	qanat
fna	fana
fna	fenna
fnaa	fenna
fola	folla
fola	foula
forn	feran
foula	folla
fqalbo	qalbo
frasak	frasek
frasik	frasek
frask	frasek
frassek	frasek
fulla	foula
fwa7ed	wa7ed
fzagora	zagora
ga3ma	ga3
gadi	ghadi
galat	ghalat
galha	gal
gali	gal
galo	gal
galt	gal
galti	gal
gelti	gal
gha	ghir
ghayaa	ghaya
ghbarti	ghabra
ghberti	ghabra
ghborat	ghabra
ghbourat	ghabra
ghbra	ghabra
ghbraa	ghabra
ghbrti	ghabra
ghebra	ghabra
gher	ghir
ghezal	ghzal
ghezala	ghzala
ghi	ghir
ghlt	ghlat
ghonia	ghonya
ghzaal	ghzal
ghzali	ghzal
ghzalin	ghzal
ghziwla	ghzala
glti	gal
glti	gelti
gna	gana
golti	gal
hablni	habel
haboubti	7biba
had	hada
hadak	hada
hadartak	hadra
hadci	hadchi
haddak	7adek
haddek	7adek
hadek	7adek
hadii	hadi
hadik	hadi
hadk	dak
hadkhi	hadchi
hadok	dak
hadraa	hadra
hadshi	hadchi
haj	7aj
haja	haj
hajaa	7aj
hala	7ala
halq	7alq
halqa	7alqa
halqaa	7alqa
hamd	7amd
hamdulilah	hamdollah
hamed	7amd
hamed	7amed
haq	7aq
harb	hareb
hariba	harib
hariban	harib
haribe	harib
haribn	harib
hariib	harib
hasa	7assa
hasbi	7asbiya
hasbia	7asbiya
hasbiya	7asbiya
hasbona	7asbiya
hasbouna	7asbiya
hasbya	7asbiya
hasn	7asan
hassa	7assa
hassbena	7asbiya
hassbiya	7asbiya
hawa	howa
hawel	7awal
hawela	7awla
hawla	7awla
hayal	hail
hayawana	7ayawan
hbiba	7biba
hchema	7chouma
hchoma	7chouma
hchouma	7chouma
hdaya	7daya
hdchi	hadchi
hder	hdar
hdr	hdar
hdra	hadra
hdrti	hdar
hed	7ed
hed	wa7ed
hedek	7adek
hedra	hadra
helqa	7alqa
herbaan	hareb
herban	hareb
heya	hiya
hint	7it
hir	ghir
hit	7it
hkhar	akhor
hkhoma	7chouma
hlaliou	hlali
hlib	7lib
hlit	khalat
hlou	7lou
hlqa	7alqa
hmaq	7maq
hmeq	7maq
hmq	7maq
hna	7na
hnaya	7na
hnin	7nin
hnini	7nini
homa	houma
houwa	howa
howwa	howa
hram	haram
hsen	7sen
hsenn	7sen
hshoma	7chouma
hssn	7sen
hta	7ta
hwa	howa
hya	hiya
i3atik	ya3tek
i3damm	i3dam
i3fo	3fou
i3fou	3fou
i3lami	i3lam
i3tak	ya3tek
i3tek	ya3tek
i3tiik	ya3tek
i3tik	ya3tek
i7raq	7raq
iamaskhak	maskhak
ichallah	inchallah
ichri	chra
iddoum	doum
idir	dir
igharaq	gharaq
ihdar	hdar
ijrram	moujrim
ikhhar	ichhar
ilaha	ilah
imaskh	maskhak
imaskhak	maskhak
imazighen	amazigh
imskhk	maskhak
in3al	n3al
in3el	n3al
in3el	n3ala
in3l	n3al
incha	inchallah
inchaa	inchallah
inchaaallah	inchallah
inchaalah	inchallah
inchaallah	inchallah
inchaeallah	inchallah
inchaeallah	machallah
inchalah	inchallah
inchallallah	inchallah
inna	ina
inssan	insan
inssana	insana
iqdar	qdar
irbe7	rbe7
isahal	sahal
isehal	sahal
ishal	sahal
ishl	sahal
islaam	islam
ismah	sma7
ismh	sma7
issahel	sahal
itba	itbat
itlaq	tlaq
itlq	tlaq
iyassar	yasser
iyesser	yasser
jaliil	jalil
jalile	jalil
jalili	jalil
jalilo	jalil
jamhor	jomhour
jamhour	jomhour
jami3	jami3an
jami3	jmi3
jami3an	jmi3
jarabte	jarabt
jarabtha	jarabt
jarabto	jarabt
jarabtoo	jarabt
jarbt	jarabt
jarbte	jarabt
jarbtha	jarabt
jarbto	jarabt
jarebt	jarabt
jarrabtha	jarabt
jatak	jatek
jatni	jat
jawabni	jawbni
jawbini	jawbni
jazayer	jazair
jbedti	jbed
jdad	jdid
jdida	jdid
jdide	jdid
jeze	jouze
jiti	jat
jlil	jalil
jmi3	jami3
jmi3	jami3an
jnb	janb
jo3	jou3
joj	jouj
jouza	jouze
jouzaa	jouze
jouzea	jouze
jouzee	jouze
joza	jouze
jozaa	jouze
joze	jouze
jozea	jouze
jozee	jouze
jrabt	jarabt
jrabtha	jarabt
jza	jouze
jzea	jouze
kaayen	kayen
kaba	kab
kadir	dir
kain	kayen
kalam	klam
kalb	kelb
kalh	khalih
kalm	klam
kamal	kamel
kamara	kemara
kaml	kamal
kaml	kamel
kanchof	nchof
kandowz	dawaz
kandwz	dawaz
kanmott	kanmot
kanmout	kanmot
kanmoute	kanmot
kano	kan
kanskon	saken
kant	kan
kantfarej	kantfaraj
kantfarj	kantfaraj
kantfraj	kantfaraj
kantfrej	kantfaraj
kantfrj	kantfaraj
kanti	kan
karik	fkarak
kas	kass
kase	kass
kat3ajbini	3jabtini
kat3jabni	3jabni
kat3jabni	3jabtini
kat3jbina	3jabtini
kat3jbni	3jabtini
katakol	takol
katkherbq	kharbaq
katkherbq	tkharbaq
katqtlni	qtaltini
katqtloni	qtaltini
katqtolni	qtaltini
katskon	saken
kay3jabni	3jabni
kay3jbo	3jbo
kayan	kayen
kaybghi	bgha
kayhdar	hdar
kayin	kayen
kayiwoslo	wsel
kayn	kayen
kayne	kayen
kaynine	kaynin
kayqtlni	qtaltini
kaywq3	waqe3
kaywqa3	waqe3
kbiira	kbira
kdba	kedba
kdob	kdoub
kel	koul
kemal	kmal
kemar	kemara
kemel	kmal
kemmel	kmal
kenti	kan
ketar	ktar
khaatar	khatar
khaay	khouya
khabze	khobz
khadma	khedma
khalihom	khali
khaliwh	khaliw
khanzaa	khanza
kharb	kharab
kharbq	kharbaq
khas	khass
khasso	khass
khassou	khass
khassou	khasou
khat	khet
khataar	khatar
khatebha	khateb
khatiir	khatar
khatir	khatar
khatirin	khattar
khawii	khawi
khay	khouya
khayna	khana
khayna	khona
khayr	khir
khayria	khayriya
khdemtek	khedma
khdma	khedma
khdra	khadra
kheir	khir
khelih	kheli
kher	khir
khetha	khet
kheti	khti
khetti	khti
khina	khana
khire	khir
khiyna	khana
khk	kho
khlaq	khalaq
khlih	khalih
khlouq	khloq
khnaze	khnaz
khoia	khouya
khokem	khokom
khokran	choukran
khoo	kho
khoot	khout
khor	akhor
khoti	khout
khou	kho
khouia	khouya
khouna	khona
khouti	khout
khouya	kho
khouyaa	khouya
khouyya	kha
khoy	kho
khoya	kha
khoya	kho
khoya	khouya
khoyaa	kho
khoyaa	khouya
khra	okhra
khsrti	khsar
kht	khet
khtha	khet
khtii	khti
khtik	khti
khtilah	khti
khty	khti
khu	kha
khuna	khona
khuu	kho
khuuya	khouya
khuya	khouya
khya	kho
kibqa	bqa
kidhak	d7ak
kidyar	kidayer
kifma	kima
klamak	klam
klamek	klam
klamk	klam
klamo	klam
klma	kalma
kmaal	kmal
kmamar	kemara
kmar	kemara
kmara	kemara
kmeel	kmal
kmel	kmal
kml	kmal
kmml	kmal
knchofk	nchof
knmot	kanmot
knmote	kanmot
knt	kant
kntfrj	kantfaraj
knti	kan
knti	kant
kol	koul
kola	koul
kolchii	kolchi
kolkhi	kolchi
kolshi	kolchi
kon	koun
koneto	kan
kont	kant
konti	kant
koulchi	kolchi
kouya	khouya
koya	khouya
krouch	karche
krouch	kerch
kt3tl	t3atal
ktachf	ktachaf
ktar	kter
ktarou	ktartou
kter	ktar
ktltini	qtaltini
ktr	kter
ktr	ktar
kun	koun
kyn	kayen
l3ahira	3ahira
l3am	3am
l3aq	l3aqa
l3asiir	3asir
l3asir	3asir
l3assir	3asir
l3ib	3ib
l3omar	3omar
l3sir	3asir
l3yalat	3yalat
l3yaqa	3yaqa
l3yat	3yalat
l7alqa	7alqa
l7iwar	7iwar
l7maq	7meq
l7moda	7moda
l7mouda	7moda
l7sab	7sab
la3alaqa	3alaqa
la7awla	7awla
la7ti	la7
laah	allah
labass	labas
labgar	bagra
lablad	blad
lach	3lach
laghbor	ghabra
lah	allah
lahawela	7awla
lahawla	7awla
lahd	la7d
lahe	allah
lahh	ilah
lahi	allah
lahowla	7awla
lahti	la7
lahya3tek	ya3tek
lakdob	kdoub
lakher	lekher
lallamaghboun	maghboun
lamdina	mdina
lamra	mra
lawlad	wlidat
lawldin	walidin
layn3l	n3al
laytlaq	tlaq
lba3dakom	ba3diatkom
lbagra	bagra
lbarnamaj	barnamaj
lbassla	basla
lbastila	bastila
lbe3dkom	ba3diatkom
lbent	bent
lbesti	lebsa
lblad	blad
lblan	blan
lbtata	btata
ldida	ldid
ldide	ldid
le3yalat	3yalat
le7ti	la7
lebsala	bsala
leghdar	ghedar
lekhr	lekher
lfad	fad
lfade	fad
lfaham	fhama
lfd	fad
lfed	fad
lfennana	fanan
lfilali	filali
lflous	flouss
lflouss	flouss
lforn	feran
lfouq	fouq
lghnia	ghonya
lghnya	ghonya
lghonia	ghonya
lghonya	ghonya
lhadra	hadra
lhalqa	7alqa
lhamam	hamam
lharba	harba
lhdra	hadra
lherba	harba
lhlqa	7alqa
lhmouda	7moda
li3dam	i3dam
li3ziz	3ziz
libgha	bgha
lijah	jah
likayen	kayen
liqasou	qas
lissala	sala
lizin	zin
ljadid	jdid
ljama3at	jama3a
ljami3	jami3
ljami3	jmi3
ljami3e	jmi3
ljazair	jazair
ljouza	jouze
ljoz	jouze
ljoza	jouze
ljozae	jouze
ljoze	jouze
lkafta	kafta
lkalb	kelb
lkaram	karam
lkarama	karama
lkarim	karim
lkelb	kelb
lkhar	lekher
lkharqom	kharqom
lkhayr	khir
lkhdra	khadra
lkhir	khir
lkhobz	khobz
lkhot	khout
lkhout	khout
lkhra	kharya
lkhrqom	kharqom
lkhsran	khsara
lkol	koul
llah	allah
llahe	allah
lmadi	madi
lmagharib	maghrib
lmaghrib	maghrib
lmagrib	maghrib
lmakina	makina
lmalik	malik
lmars	mars
lmasakh	moussakh
lmeghrib	meghrib
lmo3jabat	mo3jabat
lmo3jabin	mo3jab
lmo3jabin	mo3jabat
lmo7tawa	mo7tawa
lmoosekh	moussakh
lmosakh	moussakh
lmosama7a	sma7a
lmosekh	moussakh
lmoskhe	moussakh
lmossakh	moussakh
lmosskh	moussakh
lmotatabi3in	motabi3in
lmotatb3in	motabi3in
lmousakh	moussakh
lmousekh	moussakh
lmouskh	moussakh
lmousskh	moussakh
lmout	mout
lmoutabi3in	motabi3in
lmwskh	moussakh
lnhar	nhar
lo7	la7
lo7	lou7
lobya	loubya
loh	la7
loh	lou7
louh	lou7
loz	louz
lqaftan	qaftan
lqanat	qanat
lqanati	qanat
lqant	qant
lqat	lqa
lqftan	qaftan
lqodam	qdam
lsfar	sfar
lsrah	sara7
ltnin	tnin
lu7	la7
lvideowat	videowat
lvidioat	videowat
lwaba	waba
lwalid	walid
lwalida	walid
lwalidin	walidin
lwalidine	walidin
lwalidn	walidin
lwarqa	warqa
lwasafat	wasfa
lwasfa	wasfa
lwidad	widad
lwisam	wisam
lwlidat	wlidat
lwlidato	wlidat
lwrqa	warqa
lya	liya
lyom	lyoum
lyoma	lyoum
lyouma	lyoum
lzaml	zamal
m	ma
m3aak	m3ak
m3aanaa	m3ana
m3ah	m3a
m3aha	m3a
m3aia	m3aya
m3alim	m3alem
m3allem	m3alem
m3ay	m3aya
m3ayaa	m3aya
m3ayz	m3aya
m3elem	m3alem
m3llem	m3alem
m3lm	m3alem
m3raftch	ma3raftch
m3rftch	ma3raftch
m3ya	m3aya
m3yaa	m3aya
ma3a	m3a
ma3adi	m3andi
ma3amarni	3amarni
ma3amri	3amarni
ma3art	ma3raftch
ma3mrak	3amrak
ma3mri	3amarni
ma3mrni	3amarni
ma3rafetch	ma3raftch
ma3raftoch	ma3raftch
ma3reftch	ma3raftch
ma3rftch	ma3raftch
ma3rof	ma3rouf
maaya	m3aya
mabqinch	mabqinach
mabqitikh	mabqitich
mabrok	mabrouk
mabrouuk	mabrouk
macha	machallah
machaa	machallah
machaaallah	machallah
machaalah	machallah
machaallah	inchallah
machaallah	machallah
machaallahe	inchallah
machaallahe	machallah
machae	machallah
machaelah	machallah
machaellah	machallah
machalah	machallah
machallah	inchallah
machhalh	machallah
madroba	madrob
mafahma	mafhemtch
mafhamtch	ma3raftch
mafhamtch	mafhemtch
mafhmtch	mafhemtch
mafhtc	mafhemtch
mafiha	mafih
mafikch	mafik
mafqos	tfqas
magalch	magal
magbon	maghboun
magharib	meghrib
maghbon	maghboun
maghbona	maghboun
maghbouna	maghboun
maghdi	maghadi
maghnia	maghboun
maghreb	maghrib
maghribi	maghrib
magl	magal
magreb	maghrib
magrib	maghrib
makan	makanch
makant	makayan
makatmna	tmana
makayn	makayan
makin	makayan
makinat	makina
maknch	makanch
makrhtch	makrehtch
malak	malek
malek	malak
malikou	malik
malk	malak
malk	malek
malkdob	kdoub
malko	malkom
malou	mal
malw	mal
malwalidin	walidin
mamak	mama
mamosiqa	mousiqa
manha	mani
manho	mani
mano	mani
mant	manta
mariam	meryem
marra	mara
maryam	meryem
masakhit	msakhet
maschaallah	machallah
maschallah	machallah
masekh	maskhak
mashallah	machallah
maskina	maskin
maskine	maskin
matafaq	mtafeq
matl	matal
mawlay	moulay
mazbala	zbala
mbrok	mabrouk
mbrouk	mabrouk
mchit	mcha
mctalib	talib
mdrasti	medrasa
me3aya	m3aya
meak	m3ak
meaya	m3aya
mebrouk	mabrouk
medina	mdina
mera	mara
meriem	meryem
merra	mara
mery	meryem
meskin	maskin
messkin	maskin
metafeq	mtafeq
mezyana	mezyan
mgharba	maghrib
mghbon	maghboun
mghreb	meghrib
miladi	milad
millad	milad
miloudi	miloud
mkaleh	mkalekh
mkanch	makanch
mkayn	makayan
mnhadchi	hadchi
mo3jaba	mo3jab
mo3jabin	mo3jabat
mo7taw	mo7tawa
mobarak	moubarak
mochahada	mouchahada
mod3	modo3
mohamed	mohammed
mohtawa	mo7tawa
mohtwa	mo7tawa
mol	moul
momtil	moumatil
mora	mor
morak	mor
mosame7	sma7
moskh	moussakh
mossekh	moussakh
mossiba	moseba
mosskh	moussakh
mot	mout
motatabi3a	motabi3in
motatabi3in	motabi3in
moudira	moudir
moulai	moulay
mouskh	moussakh
moussekh	moussakh
moute	mout
mouut	mout
mowafaqa	tawfiq
mowfaqa	tawfiq
mra	mara
mrat	mra
mrid	mred
mrra	mara
msam7in	sma7a
mskin	maskin
mtafaq	mtafeq
mtafk	mtafeq
mtafq	mtafeq
mtafqe	mtafeq
mtle3	tale3
mubarak	moubarak
mussekh	moussakh
mziwan	zwin
mziwn	zwin
mzroba	zarba
n3adm	3dem
n3ala	na3la
n3arf	na3raf
n3as	n3ass
n3lat	na3la
n3raf	na3raf
n3ref	na3raf
n3rf	na3raf
n3s	n3ass
n3ss	n3ass
na3alak	n3ala
na3atalah	na3la
na3l	na3la
na3lak	n3al
na3lat	na3la
na3latu	na3la
na3ref	na3raf
na3rf	na3raf
naadi	nadi
naari	nari
nab	naseb
nadii	nadi
nady	nadi
nafham	fhama
nafs	nefs
nakar	nkar
nakarat	nkar
nakr	nkar
namot	mout
naqas	naqsa
naqees	naqsa
naqs	naqsa
nare	nari
narii	nari
narri	nari
nary	nari
nas	nass
nasab	nesab
nasb	nesab
nassab	nesab
nasse	nass
nat	nta
naw3	nou3
nchalah	inchallah
nchallah	inchallah
nchlh	inchallah
nchouf	nchof
ne3al	n3al
ne3ref	na3raf
nekar	nkar
nesabe	nesab
nessab	nesab
neta	nta
nftar	ftar
njarabha	njarab
njarabhom	njarab
njarb	njarab
njarbha	njarab
njarbo	njarab
njarebha	njarab
njrbha	njarab
njrbo	njarab
nkara	nkar
nkart	nkar
nmot	kanmot
nmout	kanmot
nmr	nemra
no3	nou3
nsab	nesab
nssab	nesab
ntaakoum	nta3kom
ntay	nta
ntbadlo	tabadol
ntfaraj	kantfaraj
ntfarj	kantfaraj
ntfraj	kantfaraj
ntfrj	kantfaraj
ntia	nti
ntina	nti
ntiya	nti
ntmna	tmana
ntoma	ntouma
nty	nti
ntybo	tyab
o3alaikom	3alaykoum
o3ziz	3ziz
obaraka	baraka
obent	bent
obin	bin
ochokran	choukran
odak	dak
odima	dima
odryfa	draifa
oflan	flan
oghniya	oghnia
oghnya	oghnia
ohani	hani
ohna	7na
ojani	jani
ojaw	jaw
ojbed	jbed
ojmi3	jmi3
okat3jabni	3jabni
okhali	khalik
okhli	khali
okhra	akhor
okht	khti
okhti	khti
olbas	labas
olghalat	ghlat
olidato	wlidat
omatbqach	mabaqich
onta	nta
onti	nti
orachid	rachid
os3aya	s3aya
otabonaw	tabonna
otalib	talib
otaqdir	taqdir
oughnia	oghnia
oukhra	okhra
oukhti	khti
oweld	weld
ozin	zina
ozit	zit
ozwin	zwin
passtila	bastila
pastila	bastila
pstila	bastila
qa7b	qa7ba
qaeida	qaida
qahb	qa7ba
qahba	qa7ba
qahe	qahwa
qahw	qahwa
qahwat	qahwa
qahwt	qahwa
qalbk	qalbak
qalboo	qalbo
qalo	qal
qalt	qal
qalw	qalwa
qana	qanat
qanate	qanat
qanati	qanat
qanon	qanoun
qanou	qanoun
qat3	qata3
qatlatni	qtaltini
qawd	qawad
qayda	qaida
qayeda	qaida
qbeel	qebal
qehba	qa7ba
qehwa	qahwa
qerib	qrab
qlbi	qalbi
qlwa	qalwa
qrab	aqrab
qtalni	qtaltini
qtaltina	qtaltini
qtaltoni	qtaltini
qteltina	qtaltini
qteltini	qtaltini
qteltoni	qtaltini
qtlatni	qtaltini
qtlni	qtaltini
qtltina	qtaltini
qtltini	qtaltini
qtltoni	qtaltini
qtni	qtaltini
qwad	qawad
qyass	qyas
qyda	qaida
raai3	rai3
raai3a	rai3
rab3	raba3
rab3	rabe3
rab3e	raba3
rab3e	rabe3
raba	raba3
raba3	rabe3
raba3e	raba3
raba3e	rabe3
rabaa	rabe3
rabbi	rab
rabe3	raba3
rabe3e	raba3
rabe3e	rabe3
rabi	rab
rabi3	raba3
rabi3	rabe3
rabi3e	raba3
rabi3e	rabe3
rabii	rab
raby	rab
raduan	radwan
radwn	radwan
rae3	rai3
rai3a	rai3
raj3	raja3
raja	rajae
rajaa	rajae
rajaaa	rajae
rajal	rajel
rajl	rajel
rajle	rajel
ramdan	remdan
ranjrbha	njarab
rasek	rasak
rasik	rasak
rask	rasak
rassak	rasak
rassoulo	rassoul
rassu	ras
raw3a	rai3
rayna	ray
rba7	rbe7
rbbi	rab
rbe	rab
rbe7	rba7
rbii	rab
rdwan	radwan
rebbi	rab
rebi	rab
rebii	rab
redouan	radwan
redouane	radwan
redwan	radwan
remdan	ramdan
ridwan	radwan
rissala	risala
rj3	rja3
rje3	rja3
rjee3	rja3
rojola	rojoula
rojula	rojoula
s3dia	sa3diya
s7a	sa7a
s7aab	s7ab
sa3	sa3a
sa3aya	s3aya
sa3dia	sa3diya
sa3y	sa3ay
sa77a	sa7a
sa7aa	sa7a
sa7btk	sa7bi
saat	sat
sabab	sbab
saboun	sabon
sadiqi	sadiq
safra	sefra
saha	sa7a
sahaa	sa7a
sahbi	sa7bi
sahed	sahd
sahha	sa7a
saide	sa3id
sakn	saken
sakna	saken
sakne	saken
saknin	saken
sakran	sekran
sakrane	sakran
sala	salat
salaa	salat
salahe	sala7
salamo	salam
salat	sala
salatt	salat
salem	salam
salema	salma
saliti	sala
salitii	sala
salm	salam
satt	sat
sayad	sayed
sayda	sayed
sayft	seft
sayid	sayed
sbab	sabab
sbabha	sbab
sbabo	sbab
se3diya	sa3diya
se77a	sa7a
se7a	sa7a
sebab	sbab
sefa	safa
seha	sa7a
sehaa	sa7a
sehd	sahd
sehha	sa7a
sekran	sakran
selma	salma
ser	sir
seyd	sayed
seyed	sayed
sghaar	sghar
sha	sa7a
shab	s7ab
shall	sahal
sharaf	charaf
shha	sa7a
shnaqa	chennaqa
shnaqa	chnaqa
sif	sayf
sife	sayf
sife	sif
sii	si
siif	sayf
siif	sif
siir	sir
sire	sir
siro	sirou
siru	sir
siyad	sayed
siyd	sayed
siyda	sayed
siyid	sayed
skran	sakran
slaamtk	slama
slaamtna	slama
slamaa	slama
slamtak	slama
slamtek	slama
slamtk	slama
slamtna	slama
slm	salam
slmtk	slama
smah	sma7
smaha	sma7a
smaytak	smayti
smh	sma7
smid	smida
smiyet	smiya
smya	smiya
soq	souq
sosiya	sousi
souq	soq
sout	sot
sraaho	sara7
srahe	sara7
srahk	sara7
ssa7a	sa7a
ssaha	sa7a
ssat	sat
sseha	sa7a
ssha	sa7a
ssi	si
ssif	sif
sslama	slama
sslamtk	slama
star	ster
stasioni	stationi
stationner	stationi
syad	sayed
syf	sif
t3atalti	t3atal
t3atel	t3atal
t3atl	t3atal
t3atlti	t3atal
t3awnoni	3awnouni
t3awnou	t3awno
t3ayrou	t3ayro
t3diti	t3aditi
t3etel	t3atal
t3liq	ta3liq
t3tel	t3atal
t3tl	t3atal
t3tlti	t3atal
t3ttl	t3atal
t3wno	t3awno
t7maq	7maq
t7zaq	7azqa
ta3one	ta3on
ta3oun	ta3on
ta7ia	ta7iya
ta7iy	ta7iya
ta7iyaa	ta7iya
ta7iyati	ta7iya
ta7ya	ta7iya
ta7yati	ta7iya
taabona	tabonna
taabonaw	tabonna
taabonawe	tabonna
taabonnaw	tabonna
taah	ta7
tabark	tabarak
tabarkalah	tbarekallah
tabarkallah	tbarekallah
tabarkellah	tbarekallah
tabarklh	tbarekallah
tabbona	tabonna
tabi3ia	tabi3iya
tabi3ya	tabi3iya
tabona	tabonna
tabonaw	tabonna
tabonnaou	tabonna
tabonnaw	tabonna
taboonaw	tabonna
tabraklh	tbarekallah
tabrkalah	tbarekallah
tabrkellah	tbarekallah
tahdr	hdar
tahia	ta7iya
tahir	taher
tahiya	ta7iya
tahiyati	ta7iya
tahm	touhma
tahya	ta7iya
tahyati	ta7iya
takdar	taqdar
takhdm	takhdam
tal3	tale3
tala3to	tale3
talaja	tlaja
talb	taleb
taleb	talib
talibe	talib
taliib	talib
talqohe	ta3leq
talt	talet
tam3	tama3
tanii	tani
tanmot	kanmot
tanmout	kanmot
taqaw	taqa
taqi	taqa
tarm	tarma
tasir	sir
tasthl	tastahal
tat3ajbini	3jabtini
tat3jabni	3jabtini
tatghbr	ghbar
tatlaq	tlaq
tawba	touba
tawfik	tawfiq
tawill	tawil
tay3jbo	3jbo
tay7	ta7
tay7	taye7
taya7	taye7
taya7ti	taye7
tayab	tayb
tayah	taye7
tayeh	taye7
tayh	ta7
tayib	tayeb
tayr	tayer
tba3klah	tbarekallah
tbaarkallah	tbarekallah
tbarak	tabarak
tbarakalah	tbarekallah
tbarcalah	tbarekallah
tbarcallah	tbarekallah
tbarek	tabarak
tbarka	tabarak
tbarkalah	tbarekallah
tbarkalallah	tbarekallah
tbarkallah	tbarekallah
tbarkallahe	tbarekallah
tbarkela	tbarekallah
tbarkelaah	tbarekallah
tbarkelah	tbarekallah
tbarkhallah	tbarekallah
tbarkillah	tbarekallah
tbarkla	tbarekallah
tbarklah	tbarekallah
tbarkllah	tbarekallah
tbarrkallah	tbarekallah
tbatklah	tbarekallah
tbdol	tabadol
tbki	bka
tbrka	tabarak
tbrkalah	tbarekallah
tbrkallah	tbarekallah
tbrkllah	tbarekallah
tchaj3oni	tachji3
tchawak	chawak
tchbhi	chabih
tdir	dir
te3aditi	t3aditi
tebarek	tabarak
tebareklah	tbarekallah
tebarklah	tbarekallah
tefdahi	tfde7
tegrissa	grisa
tejnid	tajnid
tekedbou	kdoub
tele3ti	tale3
telle3	tale3
temana	tmana
terj3i	rej3i
tfarajt	kantfaraj
tfarjt	kantfaraj
tferej	tfaraj
tfrjt	kantfaraj
thabal	hbal
thiya	ta7iya
thn	than
thya	ta7iya
tissa3	tisa3
tjawbini	jawbni
tkhdmo	khadem
tkhrbiq	tkharbiq
tlbi	tleb
tlo7	lou7
tma	tama
tmaniti	tmani
tmchi	mchi
tobi	toubi
tofiq	tawfiq
tombil	tomobil
tonobil	tomobil
tooop	top
toop	top
tope	top
topp	top
toubbi	toubi
tounis	tounes
tsma7	sma7
tstahl	tastahal
tstahli	tastahli
ttop	top
tunis	tounes
tw7achnak	twa7achnak
tw7chnak	twa7achnak
tw7khnak	twa7achnak
twa7akhnak	twa7achnak
twa7echnak	twa7achnak
twa7khnak	twa7achnak
twahachenak	twa7achnak
twahchnak	twa7achnak
twahkhnak	twa7achnak
twe7chnak	twa7achnak
twe7echnak	twa7achnak
twfiiq	tawfiq
twfiq	tawfiq
twhachnak	twa7achnak
twhchnak	twa7achnak
twichiya	twichya
twila	twil
tyhti	taye7
videoat	videowat
vidioat	videowat
vidowat	videowat
w3acha	3ach
w3aqo	3aq
w3raq	3raq
w7da	wa7ed
w7ed	7ed
w7nin	7nin
wa3a	wa3ar
wa3er	wa3ar
wa3jabni	3jabni
wa3lik	3lik
wa3r	wa3ar
wa3rar	wa3ar
wa3re	wa3ar
wa3rr	wa3ar
wa7ad	wa7ed
wa7aq	7aq
wa7d	7ad
wa7d	wa7ed
waa3r	wa3ar
wabaraka	baraka
wabaz	baz
wache	wach
wad7	wada7
wadkhl	dkhol
waghborat	ghabra
wahd	wa7ed
wahed	wa7ed
wajh	wjah
wajhak	wjah
walah	wallah
walahe	wallah
wald	weld
walde	weld
walh	wallah
walidato	wlidat
walidiha	walidin
walidikoum	walid
walidina	walidin
walidine	walidin
walidya	walid
wallh	wallah
walo	walou
walu	walou
wan3ma	ni3ma
wanari	nari
wani3ma	ni3ma
wantouma	ntouma
waq3	waqe3
waqa3	waqe3
waqa3	wqa3
waqe3	wqa3
waqtltini	qtaltini
waraja3	raja3
waraq	warqa
wasafat	wasfa
wasir	sir
wasiro	sirou
wataqdir	taqdir
wbach	bach
wbent	bent
wch	wach
wchno	chno
wedad	widad
welad	weld
welah	wallah
weldk	weld
wella	wela
wellah	wallah
weqaf	wqef
weqef	wqef
weqfo	wqef
wesal	wsal
wesame	wisam
whd	wa7ed
whna	7na
widade	widad
wisame	wisam
wissam	wisam
witlq	tlaq
wjeh	wjah
wjh	wjah
wkaynin	kaynin
wlad	weld
wlado	wlidat
wlah	wallah
wlakin	walakin
wld	weld
wldid	ldid
wlh	wallah
wlidatk	wlidat
wlidato	wlidat
wlidatou	walida
wlla	wla
wllah	wallah
wlwalid	walid
wmachallah	machallah
wni3ma	ni3ma
wnta	nta
wntouma	ntouma
wolah	wallah
wold	weld
wollah	wallah
wq	wqef
wqaaf	wqef
wqaf	wqef
wqafe	wqef
wqaff	wqef
wqafo	wqef
wqal	qal
wqeef	wqef
wqefe	wqef
wqeff	wqef
wqf	wqef
wqfe	wqef
wqft	wqef
wselti	wsal
wtoba	touba
wtop	top
wydad	widad
wyn3al	n3al
y3atik	ya3tek
y3fou	3fou
y3tik	ya3tek
y3ttik	ya3tek
y7raq	7raq
ya3atik	ya3tek
ya3fe	3fou
ya3fo	3fou
ya3tik	ya3tek
ya3tike	ya3tek
ya3tiki	ya3tek
ya3tikm	ya3tek
yaatek	ya3tek
yaatik	ya3tek
yachta7	chta7
yaetik	ya3tek
yaetike	ya3tek
yamaskhak	maskhak
yamina	mina
yamsakhkom	maskhak
yankart	nkar
yasma3ha	sme3
yasre	yasser
yastour	setra
yatek	ya3tek
yatlaq	tlaq
yawld	weld
yazaml	zamal
ybarak	barek
ydouz	daz
ye3fo	3fou
ye3fou	3fou
ye3tek	ya3tek
yesar	yasser
yesser	yasser
yghareq	gharaq
yhbel	habel
yi3tik	ya3tek
yin3al	n3al
ykhalik	khalik
ykhof	khaf
ymskhek	maskhak
ymskhk	maskhak
yn3al	n3al
yn3l	n3al
yom	youm
yousaf	yousef
youssef	yousef
youssf	yousef
youssouf	yousef
yqoul	qal
yrahmoo	ra7ma
yrbe7	rbe7
ysahal	sahal
ysm7	sma7
ysmah	sma7
ysme7	sma7
yssameh	sma7a
ytabona	tabonna
ytik	ya3tek
ytlaq	tlaq
ywqa3	waqe3
ywsl	wsal
z3ma	za3ma
zaari	za3ri
zab	zeb
zabbala	zbala
zamel	zamal
zaml	zamal
zamn	zaman
zamtk	zamt
zarda	zerda
zawaj	zawj
zawamal	zamal
zayton	zitoun
zaze	zaz
zb	zeb
zebala	zebbala
zefzafi	zafzafi
zerda	zarda
zewin	zwin
zhoo	zho
zhou	zho
ziada	ziyada
zidih	zidi
zin	zine
zine	zin
zmagriya	zmagri
zml	zamal
zobir	zoubir
zwen	zwin
zwiin	zwin
zwin	zain
zwina	zwin
zwine	zwin
zwinin	zwin
zwinn	zwin
zwun	zwin